当归饮子	train	补血剂
左归饮	train	补阴剂
耳聋左慈丸	train	补阴剂
凉血四物汤	train	补血剂
二仙汤	train	补阳剂
沙参麦冬汤	train	补阴剂
金刚丸	train	补阳剂
滋肾通关丸	train	补阴剂
内补丸	train	补阳剂
肾气丸（金匮肾气丸、八味背气丸）	train	补阳剂
调肝汤	train	补阳剂
保元汤（2）	train	补气剂
八物汤	train	补血剂
一贯煎	train	补阴剂
拯阴理劳汤	train	补阴剂
茜根散	train	补阴剂
玉液汤	train	补阴剂
六君子汤（11）	train	补气剂
柴术六君汤	train	补气剂
养荣壮肾汤	train	补阳剂
黄芪鳖甲散	train	补气剂
补肾强身片	train	补阳剂
八子固精汤	train	补阳剂
壮筋续骨丹	train	补阳剂
香茸丸	train	补阳剂
黄芪汤	train	补气剂
异功散	train	补气剂
固真汤	train	补气剂
补血定痛汤	train	补血剂
当归补血汤	train	补血剂
清海丸	train	补阴剂
祛风换肌丸	train	补血剂
益气聪明汤	train	补气剂
赞育丹	train	补阳剂
养金汤	train	补阴剂
都气丸	train	补阴剂
无比山药丸	train	补阳剂
暖贤助火汤	train	补阳剂
不倒丸	train	补阳剂
加减地黄丸	train	补血剂
右归饮	train	补阳剂
滋血汤	train	补血剂
温土毓麟汤	train	补阳剂
知柏地黄丸	train	补阴剂
妙香散	train	补气剂
安胎和气饮	train	补血剂
保元汤（5）	train	补气剂
五痿汤	train	补气剂
青蛾丸	train	补阳剂
加味四君子汤	train	补气剂
鹿茸补涩丸	train	补阳剂
调元散	train	补气剂
当归散	train	补血剂
金匮肾气丸	train	补阳剂
羊肝丸	train	补血剂
滋阴除湿汤	train	补阴剂
固阴煎	train	补阴剂
四味回阳饮	train	补阳剂
上下相资汤	train	补阴剂
胎元饮	train	补气剂
巨胜丹	train	补血剂
归肾丸	train	补阴剂
补气运脾汤	train	补气剂
竹叶黄芪汤	train	补阴剂
大补元煎	train	补血剂
人参归脾丸	train	补血剂
生血补髓汤	train	补血剂
六君子汤（12）	train	补气剂
通幽汤	train	补阴剂
补中益气汤	train	补气剂
甘露饮	train	补阴剂
参苓白术散	train	补气剂
人参紫金丹	train	补气剂
济生肾气丸加减	train	补阳剂
升陷汤	train	补气剂
四乌贼骨一蔗茹丸	train	补血剂
调元肾气丸	train	补气剂
秃鸡散	train	补阳剂
安冲汤	train	补气剂
保真汤	train	补气剂
二至丸	train	补阴剂
加味麦门冬汤	train	补阴剂
归脾汤	train	补血剂
琼玉膏	train	补阴剂
补肺阿胶汤	train	补阴剂
补肺汤	train	补气剂
增损当归丸	train	补血剂
四物汤	train	补血剂
右归丸	train	补阳剂
黄芪当归散	train	补气剂
加减复脉汤	train	补阴剂
独参汤	train	补气剂
保阴煎	train	补阴剂
定经汤	train	补血剂
麦门冬汤	train	补阴剂
人参五味子汤	train	补气剂
菟丝子散	train	补阳剂
桃红四物汤（原名‘加味四物汤”）	train	补血剂
虎潜丸	train	补阴剂
麦味地黄丸（原名：八味地黄丸）	train	补阴剂
泽兰汤	train	补血剂
六君子汤（14）	train	补气剂
人参健脾丸（汤）	train	补气剂
人参鹿茸丸	train	补阳剂
补肾壮筋汤	train	补阳剂
补肝汤	train	补阴剂
益阴汤	train	补阴剂
四君子汤（简称：四君汤）	train	补气剂
赞化薏苡仁丹	train	补阳剂
镇肾决明丸	train	补阴剂
大补阴丸	train	补阴剂
知柏地黄丸（又名：六味地黄丸加黄柏知母方）	train	补阴剂
完带汤	train	补气剂
青娥丸	train	补阳剂
石斛夜光丸	train	补阴剂
生姜甘草汤	train	补气剂
十补丸	train	补阳剂
益肾调经汤	train	补阳剂
化阴煎	train	补阴剂
地芝丸	train	补阴剂
凉血地黄汤	train	补血剂
河车大造丸	train	补阴剂
滋水清肝饮	train	补阴剂
明目地黄汤	train	补阴剂
温胞饮	train	补阳剂
益气导溺汤	train	补气剂
千金保孕丸	train	补阳剂
骨质增生丸	train	补血剂
五子衍宗丸（五子补肾丸，益肾丸）	train	补阳剂
苁蓉丸	train	补血剂
补肾地黄丸	train	补阳剂
怀山药丸（大山芋丸）	train	补气剂
升阳益胃汤	train	补气剂
小温中丸	train	补血剂
健固汤	train	补气剂
紫河车丸	train	补阳剂
举元煎	train	补气剂
青娥丸（健腰丸）	train	补阳剂
小营煎	train	补血剂
加味四物汤	train	补血剂
调肝汤（调肝散）	train	补血剂
七福饮	train	补阳剂
当归鸡血藤汤	train	补气剂
六味地黄丸（又名：地黄丸）	train	补阴剂
加味四斤丸	train	补阳剂
毓麟珠	train	补阳剂
芍药甘草汤	train	补阴剂
养血润肤饮	train	补血剂
何人饮	train	补气剂
益脾散	train	补气剂
除风益损汤	train	补血剂
温肺止流丹	train	补气剂
圣愈汤	train	补血剂
菖蒲丸	train	补血剂
温肾丸	train	补阳剂
桔梗杏仁煎	train	补阴剂
玉屏风散	train	补气剂
六君子汤（13）	train	补气剂
明目地黄丸	train	补血剂
八珍益母汤	train	补血剂
地参菊花汤	train	补阴剂
何首乌延寿丹（延寿丹）	train	补阴剂
养血当归地黄汤	train	补血剂
调经种玉汤	train	补血剂
壮本丹秘方	train	补阳剂
益胃汤	train	补阴剂
杞菊地黄丸	train	补阴剂
养精种玉汤	train	补阴剂
鹿茸丸	train	补阳剂
贞元饮	train	补血剂
增液汤	train	补阴剂
荆穗四物汤	train	补血剂
补筋丸	train	补血剂
左归丸	train	补阴剂
汤氏芎黄散	train	补血剂
胶艾汤（又名：芎归胶艾汤）	train	补血剂
济生肾气丸（加味肾气丸，资生贤气丸）	train	补阳剂
保元汤	train	补气剂
四物汤《仙》	train	补血剂
六神散	train	补气剂
两地汤	train	补阴剂
养阴清肺汤	train	补阴剂
苍附六君汤	train	补气剂
加减一阴煎	train	补阴剂
生脉散	train	补气剂
保元汤（3）	train	补气剂
麦味地黄丸	train	补阴剂
补肾明目丸	train	补阳剂
壮骨固精汤	train	补阳剂
补肾固冲丸	train	补阳剂
壮阳起痿丸	train	补阳剂
熟地首乌汤	train	补血剂
拯阳理劳汤	test	补气剂
神应养真丹	test	补血剂
四物五子汤	test	补血剂
七味都气丸	test	补阳剂
六君子汤	test	补气剂
养胃增液汤	test	补阴剂
当归芍药散	test	补血剂
济生肾气丸	test	补阳剂
还少丹（真人还少丹）	test	补血剂
肾气丸	test	补阳剂
月华丸	test	补阴剂
香砂六君子汤	test	补气剂
五汁饮	test	补阴剂
加味六味地黄丸	test	补阴剂
大补阴九（又名：大补丸）	test	补阴剂
益气升阳通络方	test	补气剂
二冬汤	test	补阴剂
黄芪六一汤	test	补气剂
补肾活血汤	test	补阳剂
七味白术散	test	补气剂
当归生姜羊肉汤	test	补血剂
补肾安胎饮	test	补阳剂
